Sample	System	Organ	CellType
ENCSR051GPK.Ganglion_Eminence_derived_primary_cultured_neurospheres.UCSF_Costello	Nervous	Brain	Neurosphere
ENCSR906HEV.Fetal_Muscle_Trunk.UW_Glass	Musculoskeletal	Muscle	Muscle
ENCSR762CJN.H1_BMP4_Derived_Trophoblast_Cultured_Cells.UCSD_Thompson	Embryonic	Trophoblast	ES.derived
ENCSR321ROU.Fetal_Kidney_Pelvis.UW_Glass	Urinary	Kidney	Kidney
ENCSR109IQO.K562_Leukemia_Cells.UConn_Graveley	Blood	Blood	Leukemia
ENCSR000AEF.GM12878_Lymphoblastoid_Cells.UConn_Graveley	Blood	Blood	Lymphoblastoid
ENCSR244ISQ.H9_Derived_Neuronal_Progenitor_Cultured_Cells.CSHL_Gingeras	Nervous	Brain	ES.derived
ENCSR446RKD.Fetal_Intestine_Small.UW_Glass	Gastrointestinal	Small Intestine	Small Intestine
ENCSR396GIH.Sigmoid_Colon.Stanford_Snyder	Gastrointestinal	Colon	Colon
ENCSR000CUA.Primary_hematopoietic_stem_cells.CSHL_Gingeras	Blood	Blood	HSC
ENCSR184FRM.Mammary_Gland_Luminal_Epithelial_Primary_Cells.UCSF_Costello	Breast	Gland	Epithelial
ENCSR000CUE.Articular_Chondrocyte_of_Knee_Joint.CSHL_Gingeras	Musculoskeletal	Cartilage	Chondrocyte
ENCSR000AAN.Pulmonary_Artery_Smooth_Muscle_Primary_Cells.CSHL_Gingeras	Respiratory	Lung	Smooth
ENCSR951NPS.Fetal_Stomach.UW_Glass	Gastrointestinal	Stomach	Stomach
ENCSR652AWW.Fetal_Muscle_Back.UW_Glass	Musculoskeletal	Muscle	Muscle
ENCSR160UAZ.Fetal_Kidney_Pelvis.UW_Glass	Urinary	Kidney	Kidney
ENCSR443JOD.Fetal_Brain_Female.UCSF_Costello	Nervous	Brain	Brain
ENCSR463JBR.Primary_T_CD4._cells_from_peripheral_blood.FHCRC_Heimfeld	Blood	Blood	T.cell
ENCSR400DJE.Fetal_Kidney_Cortex.UW_Glass	Urinary	Kidney	Kidney
ENCSR265NZF.Fetal_Spleen.UW_Glass	Immune	Spleen	Spleen
ENCSR069CMT.Fetal_Thymus.UW_Glass	Immune	Thymus	Thymus
ENCSR000CUI.Muscle_Satellite_Cultured_Cells.CSHL_Gingeras	Musculoskeletal	Muscle	Satellite
ENCSR884EVS.Fetal_Kidney_Cortex.UW_Glass	Urinary	Kidney	Kidney
ENCSR675YAS.Right_Atrium.Stanford_Snyder	Cardiovascular	Heart	Atrium
ENCSR499NEL.Fetal_Lung.UW_Glass	Respiratory	Lung	Lung
ENCSR593AMV.hESC_Derived_CD56._Ectoderm_Cultured_Cells.Harvard	Embryonic	Ectoderm	Ectoderm
ENCSR663WGC.H1_Derived_Mesenchymal_Stem_Cells.UCSD_Thomson	Embryonic	ES.derived	ES.derived
ENCSR361DRG.Fetal_Skin_Fibroblast_Abdomen.UW_Glass	Skin	Dermis	Fibroblast
ENCSR367QHR.Fetal_Thymus.UW_Glass	Immune	Thymus	Thymus
ENCSR825GWD.Sigmoid_Colon.Stanford_Snyder	Gastrointestinal	Colon	Colon
ENCSR982VYI.Fetal_Skin_Fibroblast_Scalp.UW_Glass	Skin	Dermis	Fibroblast
ENCSR718CDN.Adipose_Nuclei.Stanford_Snyder	Adipose	Adipose	Adipocyte
ENCSR531RKI.Fetal_Muscle_Trunk.UW_Glass	Musculoskeletal	Muscle	Muscle
ENCSR950PSB.H1_Cells.UCSF_Costello	Embryonic	ESC	ESC
ENCSR000AFE.Brain_Parietal_Lobe.CSHL_Gingeras	Nervous	Brain	Brain
ENCSR423LLK.Fetal_Muscle_Arm.UW_Glass	Musculoskeletal	Muscle	Muscle
ENCSR069BFN.Cortex_derived_primary_cultured_neurospheres.UCSF_Costello	Nervous	Brain	Neurosphere
ENCSR714QAF.Skin_Nevus.UCSF_Costello	Skin	Skin	Nevus
ENCSR146ZKR.Adrenal_Gland.Stanford_Snyder	Endocrine	Adrenal	Adrenal
ENCSR677MYO.Fetal_Muscle_Arm.UW_Glass	Musculoskeletal	Muscle	Muscle
ENCSR482VRI.Fetal_Intestine_Small.UW_Glass	Gastrointestinal	Small Intestine	Small Intestine
ENCSR357XTU.Primary_Natural_Killer_cells_from_peripheral_blood.FHCRC_Heimfeld	Blood	Blood	B.cell
ENCSR784PDN.Placenta_Amnion.UCSF_Costello	Reproductive	Amnion	Amnion
ENCSR843HXR.Psoas_Muscle.Stanford_Snyder	Musculoskeletal	Muscle	Muscle
ENCSR976JGI.H1_BMP4_Derived_Mesendoderm_Cultured_Cells.UCSD_Thomson	Embryonic	ES.derived	ES.derived
ENCSR698VVM.Mammary_Gland_Luminal_Epithelial_Primary_Cells.UCSF_Costello	Breast	Gland	Epithelial
ENCSR000CWN.HSMM_Skeletal_Muscle_Myoblasts_Cells.Caltech_Wold	Musculoskeletal	Muscle	Skeletal
ENCSR000AEY.Brain_Frontal_Cortex.CSHL_Gingeras	Nervous	Brain	Brain
ENCSR917YHC.Lung.Stanford_Snyder	Respiratory	Lung	Lung
ENCSR074APH.Fetal_Lung.UW_Glass	Respiratory	Lung	Lung
ENCSR620ZNQ.Fetal_Muscle_Arm.UW_Glass	Musculoskeletal	Muscle	Muscle
ENCSR000AFD.Brain_Occipital_Lobe.CSHL_Gingeras	Nervous	Brain	Brain
ENCSR317LMH.Fetal_Muscle_Arm.UW_Glass	Musculoskeletal	Muscle	Muscle
ENCSR897KTO.Alveolus_Epithelial_Primary_Cells.CSHL_Gingeras	Respiratory	Lung	Epithelial
ENCSR672JUF.Foreskin_Keratinocyte_Primary_Cells_skin03.UCSF_Costello	Skin	Epidermis	Keratinocyte
ENCSR000AAU.Umbilical_Artery_Smooth_Muscle_Primary_Cells.CSHL_Gingeras	Reproductive	Umbilical cord	Smooth
ENCSR850BGX.Fetal_Brain_Female.UCSF_Costello	Nervous	Brain	Brain
ENCSR282KJZ.ES.UCSF4_Cells.UCSF_Costello	Embryonic	ESC	ESC
ENCSR700QVJ.Fetal_Spleen.UW_Glass	Immune	Spleen	Spleen
ENCSR000BYE.T47D_Ductal_Carcinoma_Cell_Line.HAIB_Myers	Breast	Gland	Carcinoma
ENCSR944FLL.Primary_T_CD8._cells_from_peripheral_blood.FHCRC_Heimfeld	Blood	Blood	T.cell
ENCSR702IGQ.Fetal_Stomach.UW_Glass	Gastrointestinal	Stomach	Stomach
ENCSR433XCV.Right_Ventricle.Stanford_Snyder	Cardiovascular	Heart	Ventricle
ENCSR409JSP.Primary_mononuclear_cells_from_peripheral_blood.UCSF_Costello	Blood	Blood	T.cell
ENCSR977XUX.H1_Derived_Neuronal_Progenitor_Cultured_Cells.UCSD_Thomson	Nervous	Brain	ES.derived
ENCSR000AEN.K562_Leukemia_Cells.UConn_Graveley	Blood	Blood	Leukemia
ENCSR993QGR.Esophagus.Stanford_Snyder	Gastrointestinal	Esophagus	Esophagus
ENCSR125NGM.Fetal_Kidney_Cortex.UW_Glass	Urinary	Kidney	Kidney
ENCSR000CPM.NHLF_Lung_Fibroblast_Primary_Cells.CSHL_Gingeras	Respiratory	Lung	Fibroblast
ENCSR618IQY.Small_Intestine.Stanford_Snyder	Gastrointestinal	Small Intestine	Small Intestine
ENCSR655XQF.Fetal_Skin_Fibroblast_Back.UW_Glass	Skin	Dermis	Fibroblast
ENCSR066FZL.Fetal_Intestine_Large.UW_Glass	Gastrointestinal	Large Intestine	Large Intestine
ENCSR292TAP.H1_Derived_Neuron_Cultured_Cells.CSHL_Gingeras	Nervous	Brain	ES.derived
ENCSR719HRO.Small_Intestine.Stanford_Snyder	Gastrointestinal	Small Intestine	Small Intestine
ENCSR697EYE.Foreskin_Melanocyte_Primary_Cells_skin02.UCSF_Costello	Skin	Epidermis	Melanocyte
ENCSR502OTI.Psoas_Muscle.Stanford_Snyder	Musculoskeletal	Muscle	Muscle
ENCSR000AFM.Umbilical_Cord.CSHL_Gingeras	Reproductive	Umbilical cord	Umbilical cord
ENCSR930URM.Fetal_Intestine_Large.UW_Glass	Gastrointestinal	Large Intestine	Large Intestine
ENCSR000CPR.HeLa.S3_Cervical_Carcinoma_Cell_Line.CSHL_Gingeras	Reproductive	Cervix	Carcinoma
ENCSR686JJB.Adipose_Nuclei.Stanford_Snyder	Adipose	Adipose	Adipocyte
ENCSR733MWN.Fetal_Lung.UW_Glass	Respiratory	Lung	Lung
ENCSR000CUQ.HEM_Epidermal_Melanocyte_Primary_Cells.CSHL_Gingeras	Skin	Epidermis	Melanocyte
ENCSR000CPE.HepG2_Hepatocellular_Carcinoma_Cell_Line.CSHL_Gingeras	Gastrointestinal	Liver	Carcinoma
ENCSR086DZF.Fetal_Muscle_Leg.UW_Glass	Musculoskeletal	Muscle	Muscle
ENCSR320BRR.RPMI.7951_Melanoma_Cell_Line.CSHL_Gingeras	Skin	Epidermis	Melanoma
ENCSR000AAS.Trachea_Smooth_Muscle_Primary_Cells.CSHL_Gingeras	Respiratory	Lung	Smooth
ENCSR576UKA.Fetal_Muscle_Back.UW_Glass	Musculoskeletal	Muscle	Muscle
ENCSR000AAP.Pulmonary_Microvascular_Endothelial_Primary_Cells.CSHL_Gingeras	Respiratory	Lung	Endothelial
ENCSR800JXT.Brain_Germinal_Matrix.UCSF_Costello	Nervous	Brain	Brain
ENCSR000AAB.Bladder_Microvascular_Endothelial_Primary_Cells.CSHL_Gingeras	Urinary	Bladder	Endothelial
ENCSR637GBV.Fetal_Skin_Fibroblast_Back.UW_Glass	Skin	Dermis	Fibroblast
ENCSR598KJX.Adrenal_Gland.Stanford_Snyder	Endocrine	Adrenal	Adrenal
ENCSR495UXA.Fetal_Kidney.UW_Glass	Urinary	Kidney	Kidney
ENCSR002CTR.hESC_Derived_CD184._Endoderm_Cultured_Cells.Harvard	Embryonic	Endoderm	Endoderm
ENCSR828TEI.HSMM_cell_derived_Skeletal_Muscle_Myotubes_Cells.CSHL_Gingeras	Musculoskeletal	Muscle	Skeletal
ENCSR552YAE.Fetal_Kidney_Pelvis.UW_Glass	Urinary	Kidney	Kidney
ENCSR000CTX.Placental_Pericyte_Primary_Cells.CSHL_Gingeras	Reproductive	Placenta	Stromal
ENCSR447IJE.Fetal_Muscle_Leg.UW_Glass	Musculoskeletal	Muscle	Muscle
ENCSR120NEA.Fetal_Adrenal_Gland.UW_Glass	Endocrine	Adrenal	Adrenal
ENCSR102TQN.Esophagus.Stanford_Snyder	Gastrointestinal	Esophagus	Esophagus
ENCSR860HAA.Breast_variant_Human_Mammary_Epithelial_Cells_vHMEC.UCSF_Costello	Breast	Skin	Epithelial
ENCSR015EMF.Fetal_Kidney_Cortex.UW_Glass	Urinary	Kidney	Kidney
ENCSR000CUN.HMEC_Mammary_Epithelial_Primary_Cells.CSHL_Gingeras	Breast	Skin	Epithelial
ENCSR468FBC.Fetal_Thymus.UW_Glass	Immune	Thymus	Thymus
ENCSR542OHE.Fetal_Spinal_Cord.UW_Glass	Nervous	Brain	Spinal cord
ENCSR000CUG.Saphenous_Vein_Endothelial_Primary_Cells.CSHL_Gingeras	Cardiovascular	Vein	Endothelial
ENCSR436ZKE.Fetal_Kidney_Cortex.UW_Glass	Urinary	Kidney	Kidney
ENCSR561WEX.Fetal_Muscle_Leg.UW_Glass	Musculoskeletal	Muscle	Muscle
ENCSR000AAJ.Dermis_Lymphatic_Vessel_Endothelial_Primary_Cell.CSHL_Gingeras	Skin	Dermis	Endothelial
ENCSR083HYC.H1_BMP4_Derived_Trophoblast_Cultured_Cells.UCSD_Thompson	Embryonic	Trophoblast	ES.derived
ENCSR629VMZ.Pancreas.Stanford_Snyder	Endocrine	Pancreas	Pancreas
ENCSR000CUM.Subcutaneous_Preadipocyte.CSHL_Gingeras	Adipose	Adipose	Preadipocyte
ENCSR373BDG.Kidney_Epithelial_Primary_Cells.CSHL_Gingeras	Urinary	Kidney	Epithelial
ENCSR000AFB.Liver.CSHL_Gingeras	Gastrointestinal	Liver	Liver
ENCSR857VKL.Fetal_Intestine_Large.UW_Glass	Gastrointestinal	Large Intestine	Large Intestine
ENCSR000AEC.GM12878_Lymphoblastoid_Cells.CSHL_Gingeras	Blood	Blood	Lymphoblastoid
ENCSR468ION.HepG2_Hepatocellular_Carcinoma_Cell_Line.UConn_Graveley	Gastrointestinal	Liver	Carcinoma
ENCSR763NOO.Aorta.Stanford_Snyder	Cardiovascular	Aorta	Aorta
ENCSR000CUD.Bone_Marrow_Derived_Cultured_Mesenchymal_Stem_Cells.CSHL_Gingeras	Musculoskeletal	Bone	Stromal
ENCSR249CKG.Chorion.UCSF_Costello	Embryonic	Chorion	Chorion
ENCSR174ESD.Fetal_Muscle_Leg.UW_Glass	Musculoskeletal	Muscle	Muscle
ENCSR830HIN.Primary_hematopoietic_stem_cells.FHCRC_Heimfeld	Blood	Blood	HSC
ENCSR472PBS.hESC_Derived_CD184._Endoderm_Cultured_Cells.Harvard	Embryonic	Endoderm	Endoderm
ENCSR653DFZ.G401_Rhabdoid_Tumor.CSHL_Gingeras	Urinary	Kidney	Rhabdoid
ENCSR000BYM.Panc1_Epithelioid_Carcinoma_Cell_Line.HAIB_Myers	Gastrointestinal	Pancreas	Carcinoma
ENCSR000AFO.Camera.type_Eye.CSHL_Gingeras	Eye	Eye	Eye
ENCSR001ODS.Primary_mononuclear_cells_from_peripheral_blood.UCSF_Costello	Blood	Blood	T.cell
ENCSR851GNB.Foreskin_Fibroblast_Primary_Cells_skin02.UCSF_Costello	Skin	Dermis	Fibroblast
ENCSR910QOX.Spleen.Stanford_Snyder	Immune	Spleen	Spleen
ENCSR044JAQ.Fetal_Lung.UW_Glass	Respiratory	Lung	Lung
ENCSR000AFF.Skeletal_Muscle_Female.CSHL_Gingeras	Musculoskeletal	Muscle	Skeletal
ENCSR000EYR.HepG2_Hepatocellular_Carcinoma_Cell_Line.Caltech_Wold	Gastrointestinal	Liver	Carcinoma
ENCSR969JYY.Brain_Germinal_Matrix.UCSF_Costello	Nervous	Brain	Brain
ENCSR261ISO.Foreskin_Fibroblast_Primary_Cells_skin03.UCSF_Costello	Skin	Dermis	Fibroblast
ENCSR510PSL.Spleen.Stanford_Snyder	Immune	Spleen	Spleen
ENCSR000COY.HSMM_Skeletal_Muscle_Myoblasts_Cells.CSHL_Gingeras	Musculoskeletal	Muscle	Skeletal
ENCSR861SOG.Fetal_Lung.UW_Glass	Respiratory	Lung	Lung
ENCSR999ZCI.Sigmoid_Colon.Stanford_Snyder	Gastrointestinal	Colon	Colon
ENCSR000CWP.LHCN.M2_Skeletal_Muscle_Myoblast_Cells.Caltech_Wold	Musculoskeletal	Muscle	Skeletal
ENCSRMAR043.Primary_T_helper_cells_from_peripheral_blood.Broad_Bernstein	Blood	Blood	T.cell
ENCSR333FZW.Fetal_Spinal_Cord.UW_Glass	Nervous	Brain	Spinal cord
ENCSR000CWO.LHCN.M2_Skeletal_Muscle_Myoblast_Cells.Caltech_Wold	Musculoskeletal	Muscle	Skeletal
ENCSR000CUB.Hair_Follicle_Dermal_Papilla_Primary_Cells.CSHL_Gingeras	Skin	Dermis	Follicular
ENCSR104ZDH.Placenta.UCSF_Costello	Reproductive	Placenta	Placenta
ENCSRMAR041.Primary_T_helper_cells_PMA.I_stimulated.Broad_Bernstein	Blood	Blood	T.cell
ENCSR999CPT.Placenta.UCSF_Costello	Reproductive	Placenta	Placenta
ENCSR000AAK.Dermis_Microvascular_Lymphatic_Vessel_Endothelial_Primary_Cells.CSHL_Gingeras	Skin	Dermis	Endothelial
ENCSR348EFG.HUES64_Cells.Harvard	Embryonic	ESC	ESC
ENCSR663IOE.Spleen.Stanford_Snyder	Immune	Spleen	Spleen
ENCSR000AAA.Aortic_Smooth_Muscle.CSHL_Gingeras	Cardiovascular	Aorta	Smooth
ENCSR000CPT.MCF.7_Mammary_Gland_Adenocarcinoma_Cell_Line.CSHL_Gingeras	Breast	Gland	Adenocarcinoma
ENCSR522XTV.Fetal_Muscle_Back.UW_Glass	Musculoskeletal	Muscle	Muscle
ENCSR382XJF.hESC_Derived_CD56._Ectoderm_Cultured_Cells.Harvard	Embryonic	Ectoderm	Ectoderm
ENCSR922VBO.Gastric.Stanford_Snyder	Gastrointestinal	Stomach	Stomach
ENCSR000AAO.NHLF_Lung_Fibroblast_Primary_Cells.CSHL_Gingeras	Respiratory	Lung	Fibroblast
ENCSR000AAC.Bladder_Smooth_Muscle.CSHL_Gingeras	Urinary	Bladder	Smooth
ENCSR000CWQ.MCF.7_Mammary_Gland_Adenocarcinoma_Cell_Line.Caltech_Wold	Breast	Gland	Adenocarcinoma
ENCSR000EYN.GM12878_Lymphoblastoid_Cells.Caltech_Wold	Blood	Blood	Lymphoblastoid
ENCSR000CON.A549_EtOH_pt02pct_Lung_Carcinoma_Cell_Line.CSHL_Gingeras	Respiratory	Lung	Carcinoma
ENCSR229JRA.Fetal_Thymus.UW_Glass	Immune	Thymus	Thymus
ENCSR908ZAS.H9_Derived_Liver_Cultured_Cells.CSHL_Gingeras	Gastrointestinal	Liver	ES.derived
ENCSR000AEQ.K562_Leukemia_Cells.Caltech_Wold	Blood	Blood	Leukemia
ENCSR560MDQ.Fetal_Lung.UW_Glass	Respiratory	Lung	Lung
ENCSR107OEQ.Ganglion_Eminence_derived_primary_cultured_neurospheres.UCSF_Costello	Nervous	Brain	Neurosphere
ENCSR239EBA.Primary_T_helper_naive_cells_from_peripheral_blood.UCSF_Costello	Blood	Blood	T.cell
ENCSR669KQU.SK.MEL.5_Malignant_Melanoma_Cell_Line.CSHL_Gingeras	Skin	Epidermis	Melanoma
ENCSR363BVC.Fetal_Intestine_Large.UW_Glass	Gastrointestinal	Large Intestine	Large Intestine
ENCSR755LFM.Fetal_Testes.UW_Glass	Reproductive	Testes	Testes
ENCSR815UVL.Mammary_Microvascular_Endothelial_Primary_Cells.CSHL_Gingeras	Breast	Vascular	Endothelial
ENCSR000CUR.HEM_Epidermal_Melanocyte_Primary_Cells.CSHL_Gingeras	Skin	Epidermis	Melanocyte
ENCSR150JIX.Fetal_Intestine_Small.UW_Glass	Gastrointestinal	Small Intestine	Small Intestine
ENCSR880XLM.Placenta.UW_Glass	Reproductive	Placenta	Placenta
ENCSR704ASN.Mammary_Gland_Stem_Cells.UCSF_Costello	Breast	Gland	Stem
ENCSR000EYS.HUVEC_Umbilical_Vein_Endothelial_Primary_Cells.Caltech_Wold	Reproductive	Umbilical cord	Endothelial
ENCSR980UEY.Gastric.Stanford_Snyder	Gastrointestinal	Stomach	Stomach
ENCSR769LNJ.Left_Ventricle.Stanford_Snyder	Cardiovascular	Heart	Ventricle
ENCSR000AAE.Bronchial_Smooth_Muscle.CSHL_Gingeras	Respiratory	Lung	Smooth
ENCSR518XRJ.Pancreatic_Islets.UCSF_Costello	Endocrine	Pancreas	Islet
ENCSR364IBB.Fetal_Muscle_Arm.UW_Glass	Musculoskeletal	Muscle	Muscle
ENCSR413LXW.Fetal_Kidney_Cortex.UW_Glass	Urinary	Kidney	Kidney
ENCSR763CQW.Primary_T_cells_from_peripheral_blood.FHCRC_Heimfeld	Blood	Blood	T.cell
ENCSR198TKA.Kidney_Mesangial_Primary_Cells.CSHL_Gingeras	Urinary	Kidney	Stromal
ENCSR239GFM.Brain_Hippocampus_Middle.Broad_Bernstein	Nervous	Brain	Brain
ENCSR516VDS.Fetal_Muscle_Lower_Limb_Skeletal.UW_Glass	Musculoskeletal	Muscle	Skeletal
ENCSR575OHC.Fetal_Muscle_Arm.UW_Glass	Musculoskeletal	Muscle	Muscle
ENCSR224HFZ.Mammary_Gland_Myoepithelial_Primary_Cells.UCSF_Costello	Breast	Gland	Epithelial
ENCSR000COX.HMEC_Mammary_Epithelial_Primary_Cells.CSHL_Gingeras	Breast	Skin	Epithelial
ENCSR196ARY.Mammary_Gland_Fibroblast_Primary_Cells.UCSF_Costello	Breast	Gland	Fibroblast
ENCSR000CUT.Primary_mononuclear_cells_from_peripheral_blood.CSHL_Gingeras	Blood	Blood	T.cell
ENCSRMAR039.Primary_T_helper_naive_cells_from_peripheral_blood.Broad_Bernstein	Blood	Blood	T.cell
ENCSR620NSN.Bronchial_Fibroblast_Primary_Cells.CSHL_Gingeras	Respiratory	Lung	Fibroblast
ENCSR571BML.Pancreas.Stanford_Snyder	Endocrine	Pancreas	Pancreas
ENCSR043RSE.H1_Cells.UCSD_Thomson	Embryonic	ESC	ESC
ENCSR000CUJ.Fibroblast_of_the_Aortic_Adventitia.CSHL_Gingeras	Cardiovascular	Aorta	Fibroblast
ENCSR278UYN.Lung.Stanford_Snyder	Respiratory	Lung	Lung
ENCSR670WQY.H1_Cells.UCSD_Thomson	Embryonic	ESC	ESC
ENCSR872LTT.hESC_Derived_CD56._Ectoderm_Cultured_Cells.Harvard	Embryonic	Ectoderm	Ectoderm
ENCSR990LHE.Fetal_Muscle_Arm.UW_Glass	Musculoskeletal	Muscle	Muscle
ENCSR894WMQ.LHCN.M2_Skeletal_Muscle_Myoblast_Cells.CSHL_Gingeras	Musculoskeletal	Muscle	Skeletal
ENCSR667JTA.MCF.7_Mammary_Gland_Adenocarcinoma_Cell_Line.UConn_Graveley	Breast	Gland	Adenocarcinoma
ENCSR500UOD.hESC_Derived_CD56._Mesoderm_Cultured_Cells.Harvard	Embryonic	Mesoderm	Mesoderm
ENCSR222IGR.Fetal_Lung.UW_Glass	Respiratory	Lung	Lung
ENCSR000CTV.Primary_CD20._B_cells_from_peripheral_blood.CSHL_Gingeras	Blood	Blood	B.cell
ENCSR000AFG.Fetal_Body_Skin.CSHL_Gingeras	Skin	Skin	Skin
ENCSR000CTZ.Adipose_Derived_Mesenchymal_Stem_Cell_Cultured_Cells.CSHL_Gingeras	Adipose	Adipose	MSC
ENCSR233IJT.NH.A_Astrocytes_Primary_Cells.CSHL_Gingeras	Nervous	Brain	Astrocyte
ENCSR711NGL.Fetal_Muscle_Upper_Limb_Skeletal.UW_Glass	Musculoskeletal	Muscle	Skeletal
ENCSR000AFL.Fetal_Tongue.CSHL_Gingeras	Tongue	Tongue	Tongue
ENCSR420NLC.PC.3_Prostate_Adenocarcinoma_Cell_Line.CSHL_Gingeras	Reproductive	Prostate	Adenocarcinoma
ENCSR052FJA.H9_Derived_Smooth_Muscle_Cultured_Cells.CSHL_Gingeras	Musculoskeletal	Muscle	ES.derived
ENCSRMAR042.Primary_T_helper_17_cells_PMA.I_stimulated.Broad_Bernstein	Blood	Blood	T.cell
ENCSR470JHE.Brain_Cerebellum.UCSF_Costello	Nervous	Brain	Brain
ENCSR920UAO.NH.A_Astrocytes_Primary_Cells.UCSF_Costello	Nervous	Brain	Astrocyte
ENCSR985KAT.HepG2_Hepatocellular_Carcinoma_Cell_Line.UConn_Graveley	Gastrointestinal	Liver	Carcinoma
ENCSR995BHD.Aorta.Stanford_Snyder	Cardiovascular	Aorta	Aorta
ENCSR738PHQ.HUES64_Cells.Harvard	Embryonic	ESC	ESC
ENCSR305NXN.Fetal_Muscle_Arm.UW_Glass	Musculoskeletal	Muscle	Muscle
ENCSR572FXC.Fetal_Lung.UW_Glass	Respiratory	Lung	Lung
ENCSR000AEO.K562_Leukemia_Cells.UConn_Graveley	Blood	Blood	Leukemia
ENCSR406YML.Fetal_Muscle_Arm.UW_Glass	Musculoskeletal	Muscle	Muscle
ENCSR555LFY.Foreskin_Fibroblast_Primary_Cells_skin01.UCSF_Costello	Skin	Dermis	Fibroblast
ENCSR239BBI.Fetal_Muscle_Back.UW_Glass	Musculoskeletal	Muscle	Muscle
ENCSR817TLH.Psoas_Muscle.Stanford_Snyder	Musculoskeletal	Muscle	Muscle
ENCSR919QJT.H4_Neuroglioma_Cell_Line.CSHL_Gingeras	Nervous	Brain	Neuroglioma
ENCSR000CUL.Fibroblast_of_Villous_Mesenchyme.CSHL_Gingeras	Reproductive	Mesenchyme	Fibroblast
ENCSR700BEW.H1_BMP4_Derived_Mesendoderm_Cultured_Cells.UCSD_Thomson	Embryonic	ES.derived	ES.derived
ENCSR534JVH.Fetal_Intestine_Small.UW_Glass	Gastrointestinal	Small Intestine	Small Intestine
ENCSR775KCE.Thymus.Stanford_Snyder	Immune	Thymus	Thymus
ENCSR094RGI.Fetal_Muscle_Back.UW_Glass	Musculoskeletal	Muscle	Muscle
ENCSR039ICU.Small_Intestine.Stanford_Snyder	Gastrointestinal	Small Intestine	Small Intestine
ENCSR352GCS.Fetal_Kidney_Pelvis.UW_Glass	Urinary	Kidney	Kidney
ENCSR000AEZ.Fetal_Heart.CSHL_Gingeras	Cardiovascular	Heart	Heart
ENCSR433YBD.Mammary_Gland_Stem_Cells.UCSF_Costello	Breast	Gland	Stem
ENCSR022MON.Fetal_Skin_Fibroblast_Scalp.UW_Glass	Skin	Dermis	Fibroblast
ENCSR000AFA.Fetal_Kidney_Metanephros.CSHL_Gingeras	Urinary	Kidney	Kidney
ENCSR938LSP.iPS_PGP1_Cells.CSHL_Gingeras	iPS	iPS	iPS
ENCSR555BCP.Fetal_Adrenal_Gland.UW_Glass	Endocrine	Adrenal	Adrenal
ENCSR000CWK.GM12891_Lymphoblastoid_Cells.Caltech_Wold	Blood	Blood	Lymphoblastoid
ENCSR572EET.H1_Derived_Neuronal_Progenitor_Cultured_Cells.UCSD_Thomson	Nervous	Brain	ES.derived
ENCSR808WMY.Mammary_Gland_Myoepithelial_Primary_Cells.UCSF_Costello	Breast	Gland	Epithelial
ENCSR861QKF.Primary_T_CD8._cells_from_peripheral_blood.FHCRC_Heimfeld	Blood	Blood	T.cell
ENCSR286KWP.Fetal_Intestine_Large.UW_Glass	Gastrointestinal	Large Intestine	Large Intestine
ENCSR759WPF.Fetal_Kidney_Cortex.UW_Glass	Urinary	Kidney	Kidney
ENCSR907KDH.Fetal_Kidney.UW_Glass	Urinary	Kidney	Kidney
ENCSR490SQH.ES.WA7_Cells.CSHL_Gingeras	Embryonic	ESC	ESC
ENCSR000AFC.Fetal_Lung.CSHL_Gingeras	Respiratory	Lung	Lung
ENCSR929HDF.Breast_variant_Human_Mammary_Epithelial_Cells_vHMEC.UCSF_Costello	Breast	Skin	Epithelial
ENCSR000CTT.SK.N.SH_Neuroblastoma_Cell_Line.CSHL_Gingeras	Nervous	Metastasis	Neuroblastoma
ENCSR338FSZ.Chorion.UCSF_Costello	Embryonic	Chorion	Chorion
ENCSR891JVD.Fetal_Muscle_Back.UW_Glass	Musculoskeletal	Muscle	Muscle
ENCSR968WKR.Bipolar_Spindle_Neuron_Cultured_Cells.CSHL_Gingeras	Nervous	Brain	Neuron
ENCSR680AAZ.Adrenal_Gland.Stanford_Snyder	Endocrine	Adrenal	Adrenal
ENCSR148SUU.Mammary_Gland_Luminal_Epithelial_Primary_Cells.UCSF_Costello	Breast	Gland	Epithelial
ENCSR523EDD.Fetal_Intestine_Small.UW_Glass	Gastrointestinal	Small Intestine	Small Intestine
ENCSR785OCX.Fetal_Muscle_Arm.UW_Glass	Musculoskeletal	Muscle	Muscle
ENCSR313TJR.Primary_mononuclear_cells_from_peripheral_blood.UCSF_Costello	Blood	Blood	T.cell
ENCSR332DBS.LHCN.M2_Skeletal_Muscle_Myoblast_Cells.CSHL_Gingeras	Musculoskeletal	Muscle	Skeletal
ENCSR489KLG.Primary_T_helper_2_memory_cells_from_peripheral_blood.UCSF_Costello	Blood	Blood	T.cell
ENCSR371VGV.Uterus_Myometrial_Smooth_Muscle_Primary_Cells.CSHL_Gingeras	Reproductive	Uterus	Smooth
ENCSR000CWM.HCT116_Colorectal_Carcinoma_Cell_Line.Caltech_Wold	Gastrointestinal	Colorectal	Carcinoma
ENCSR000CUP.Placental_Epithelial_Primary_Cells.CSHL_Gingeras	Reproductive	Placenta	Epithelial
ENCSR071ZMO.Kidney.Stanford_Snyder	Urinary	Kidney	Epithelial
ENCSR000AFZ.Skeletal_Muscle_Male.CSHL_Gingeras	Musculoskeletal	Muscle	Skeletal
ENCSR027EJD.Fetal_Muscle_Back.UW_Glass	Musculoskeletal	Muscle	Muscle
ENCSR275ZLF.H1_Derived_Mesenchymal_Stem_Cells.UCSD_Thomson	Embryonic	ES.derived	ES.derived
ENCSR000BYK.BE2C_Neuroblastoma_Cell_Line.HAIB_Myers	Nervous	Brain	Neuroblastoma
ENCSR100JHX.Mammary_Gland_Myoepithelial_Primary_Cells.UCSF_Costello	Breast	Gland	Epithelial
ENCSR504VXC.A375_Malignant_Melanoma_Cell_Line.CSHL_Gingeras	Skin	Epidermis	Melanoma
ENCSR000AEE.GM12878_Lymphoblastoid_Cells.UConn_Graveley	Blood	Blood	Lymphoblastoid
ENCSR693CSQ.Left_Ventricle.Stanford_Snyder	Cardiovascular	Heart	Ventricle
ENCSR851BRK.hESC_Derived_CD56._Ectoderm_Cultured_Cells.Harvard	Embryonic	Ectoderm	Ectoderm
ENCSR452VLO.Foreskin_Keratinocyte_Primary_Cells_skin02.UCSF_Costello	Skin	Epidermis	Keratinocyte
ENCSR971GPJ.HT.29_Colorectal_Adenocarcinoma_Cell_Line.CSHL_Gingeras	Gastrointestinal	Colorectal	Adenocarcinoma
ENCSR009MVJ.Cortex_derived_primary_cultured_neurospheres.UCSF_Costello	Nervous	Brain	Neurosphere
ENCSR000CTK.IMR90_Fetal_Lung_Fibroblasts_Cell_Line.CSHL_Gingeras	Respiratory	Lung	Fibroblast
ENCSR741QEH.Adipose_Nuclei.Stanford_Snyder	Adipose	Adipose	Adipocyte
ENCSR688YOZ.Fetal_Adrenal_Gland.UW_Glass	Endocrine	Adrenal	Adrenal
ENCSR175CNQ.Fetal_Thymus.UW_Glass	Immune	Thymus	Thymus
ENCSR783BUO.Fetal_Stomach.UW_Glass	Gastrointestinal	Stomach	Stomach
ENCSR000AFH.Fetal_Spinal_Cord.CSHL_Gingeras	Nervous	Brain	Spinal cord
ENCSR699YJR.Fetal_Muscle_Leg.UW_Glass	Musculoskeletal	Muscle	Muscle
ENCSR621FYE.Fetal_Intestine_Small.UW_Glass	Gastrointestinal	Small Intestine	Small Intestine
ENCSR634LOX.Foreskin_Melanocyte_Primary_Cells_skin03.UCSF_Costello	Skin	Epidermis	Melanocyte
ENCSR000CTQ.IMR90_Fetal_Lung_Fibroblasts_Cell_Line.CSHL_Gingeras	Respiratory	Lung	Fibroblast
ENCSR729ZII.Fetal_Muscle_Back.UW_Glass	Musculoskeletal	Muscle	Muscle
ENCSR878EUT.Kidney_Glomerular_Endothelial_Primary_Cells.CSHL_Gingeras	Urinary	Kidney	Endothelial
ENCSR000COZ.HUVEC_Umbilical_Vein_Endothelial_Primary_Cells.CSHL_Gingeras	Reproductive	Umbilical cord	Endothelial
ENCSR192NBO.Mammary_Gland_Fibroblast_Primary_Cells.UCSF_Costello	Breast	Gland	Fibroblast
ENCSR905LVO.Primary_monocytes_from_peripheral_blood.FHCRC_Heimfeld	Blood	Blood	B.cell
ENCSR706XCG.Placenta.UCSF_Costello	Reproductive	Placenta	Placenta
ENCSR859KGW.Fetal_Intestine_Large.UW_Glass	Gastrointestinal	Large Intestine	Large Intestine
ENCSR863BUL.Fetal_Heart.UW_Glass	Cardiovascular	Heart	Heart
ENCSR000AFI.Fetal_Stomach.CSHL_Gingeras	Gastrointestinal	Stomach	Stomach
ENCSR000AEX.Brain_Diencephalon.CSHL_Gingeras	Nervous	Brain	Brain
ENCSR822AOE.Fetal_Kidney_Cortex.UW_Glass	Urinary	Kidney	Kidney
ENCSR000AEW.Brain_Cerebellum.CSHL_Gingeras	Nervous	Brain	Brain
ENCSR534UXT.Placenta_Amnion.UCSF_Costello	Reproductive	Amnion	Amnion
ENCSR971KNW.MG.63_Osteosarcoma_Cell_Line.CSHL_Gingeras	Musculoskeletal	Bone	Sarcoma
ENCSR110BDY.Cardiac_Atrium_Fibroblast_Primary_Cells.CSHL_Gingeras	Cardiovascular	Heart	Fibroblast
ENCSR725TPW.Ovary.Stanford_Snyder	Reproductive	Ovary	Ovary
ENCSR777ONH.Fetal_Intestine_Large.UW_Glass	Gastrointestinal	Large Intestine	Large Intestine
ENCSR000EYO.K562_Leukemia_Cells.Caltech_Wold	Blood	Blood	Leukemia
ENCSR444WHQ.HSMM_Skeletal_Muscle_Myoblasts_Cells.CSHL_Gingeras	Musculoskeletal	Muscle	Skeletal
ENCSR806ESH.Fetal_Muscle_Back.UW_Glass	Musculoskeletal	Muscle	Muscle
ENCSR000AAV.Uterine_Smooth_Muscle_Primary_Cells.CSHL_Gingeras	Reproductive	Uterus	Smooth
ENCSR929KRW.Fetal_Kidney_Pelvis.UW_Glass	Urinary	Kidney	Kidney
ENCSR740OPV.Fetal_Adrenal_Gland.UW_Glass	Endocrine	Adrenal	Adrenal
ENCSR714KDG.Liver.Stanford_Snyder	Gastrointestinal	Liver	Liver
ENCSR047LLJ.Fetal_Heart.UW_Glass	Cardiovascular	Heart	Heart
ENCSR000BXX.Jurkat_Lymphoblastoid_Cell_Line.HAIB_Myers	Blood	Blood	Lymphoblastoid
ENCSR919MZM.Endometrial_Microvascular_Endothelial_Primary_Cells.CSHL_Gingeras	Reproductive	Endometrium	Endothelial
ENCSR793CEK.Placenta.UCSF_Costello	Reproductive	Placenta	Placenta
ENCSR702IMR.Fetal_Kidney.UW_Glass	Urinary	Kidney	Kidney
ENCSR000CPH.K562_Leukemia_Cells.CSHL_Gingeras	Blood	Blood	Leukemia
ENCSR335GET.Fetal_Adrenal_Gland.UW_Glass	Endocrine	Adrenal	Adrenal
ENCSR860DST.Fetal_Muscle_Leg.UW_Glass	Musculoskeletal	Muscle	Muscle
ENCSRMAR040.Primary_T_helper_1_memory_cells_from_peripheral_blood.Broad_Bernstein	Blood	Blood	T.cell
ENCSR043KVA.Ganglion_Eminence_derived_primary_cultured_neurospheres.UCSF_Costello	Nervous	Brain	Neurosphere
ENCSR158XIJ.Fetal_Thymus.UW_Glass	Immune	Thymus	Thymus
ENCSR547TNE.Fetal_Muscle_Arm.UW_Glass	Musculoskeletal	Muscle	Muscle
ENCSR001HHK.Oci.Ly.7_B_Cell_Non.Hodgkin_Lymphoma_Cell_Line.CSHL_Gingeras	Blood	Blood	Lymphoma
ENCSR580GSX.A172_Glioblastoma_Cell_Line.CSHL_Gingeras	Nervous	Brain	Glioblastoma
ENCSR000CUH.NHDF.Ad_Adult_Dermal_Fibroblast_Primary_Cells.CSHL_Gingeras	Skin	Dermis	Fibroblast
ENCSR545WAC.Fetal_Muscle_Leg.UW_Glass	Musculoskeletal	Muscle	Muscle
ENCSR451KXG.Ganglion_Eminence_derived_primary_cultured_neurospheres.UCSF_Costello	Nervous	Brain	Neurosphere
ENCSR000AAG.Coronary_Artery_Smooth_Muscle_Primary_Cells.CSHL_Gingeras	Cardiovascular	Heart	Smooth
ENCSR000CUK.Aortic_Endothelial_Primary_Cells.CSHL_Gingeras	Cardiovascular	Aorta	Endothelial
ENCSR424TSZ.Fetal_Kidney_Pelvis.UW_Glass	Urinary	Kidney	Kidney
ENCSR133YMF.Foreskin_Keratinocyte_Primary_Cells_skin01.UCSF_Costello	Skin	Epidermis	Keratinocyte
ENCSR928CEQ.Fetal_Kidney_Pelvis.UW_Glass	Urinary	Kidney	Kidney
ENCSR164OCT.NCI.H460_Large_Cell_Lung_Cancer_Cell_Line.CSHL_Gingeras	Respiratory	Lung	Carcinoma
ENCSR000AEU.Liver.CSHL_Gingeras	Gastrointestinal	Liver	Liver
ENCSR000AAF.Coronary_Artery_Endothelial_Primary_Cellls.CSHL_Gingeras	Cardiovascular	Heart	Endothelial
ENCSR000AFJ.Brain_Inferior_Temporal_Lobe.CSHL_Gingeras	Nervous	Brain	Brain
ENCSR000BYA.Ishikawa_Endometrial_Adenocarcinoma_Cell_Line.HAIB_Myers	Reproductive	Endometrium	Adenocarcinoma
ENCSR000COP.BJ_Foreskin_Fibroblast_Cell_Line.CSHL_Gingeras	Skin	Dermis	Fibroblast
ENCSR000AEM.K562_Leukemia_Cells.CSHL_Gingeras	Blood	Blood	Leukemia
ENCSR592EZK.Fetal_Lung.UW_Glass	Respiratory	Lung	Lung
ENCSR584JXD.Caki.2_Renal_Clear_Cell_Carcinoma_Cell_Line.CSHL_Gingeras	Urinary	Kidney	Carcinoma
ENCSRMAR044.Primary_T_regulatory_cells_from_peripheral_blood.Broad_Bernstein	Blood	Blood	T.cell
ENCSR448DCX.Bladder.Stanford_Snyder	Urinary	Bladder	Bladder
ENCSR212AMA.Fetal_Kidney.UW_Glass	Urinary	Kidney	Kidney
ENCSR000CWR.NHLF_Lung_Fibroblast_Primary_Cells.Caltech_Wold	Respiratory	Lung	Fibroblast
ENCSR000AAQ.Kidney_Cortical_Epithelial_Primary_Cells.CSHL_Gingeras	Urinary	Kidney	Epithelial
ENCSR543TQW.Fetal_Kidney_Pelvis.UW_Glass	Urinary	Kidney	Kidney
ENCSR549DVY.Fetal_Stomach.UW_Glass	Gastrointestinal	Stomach	Stomach
ENCSR571IUW.Fetal_Stomach.UW_Glass	Gastrointestinal	Stomach	Stomach
ENCSR000AAD.Bronchial_Epithelial_Primary_Cells.CSHL_Gingeras	Respiratory	Lung	Epithelial
ENCSR000AAR.Tracheal_Epithelial_Primary_Cells.CSHL_Gingeras	Respiratory	Lung	Epithelial
ENCSR545MEZ.Primary_T_CD4._cells_from_peripheral_blood.FHCRC_Heimfeld	Blood	Blood	T.cell
ENCSR626UKX.Foreskin_Melanocyte_Primary_Cells_skin01.UCSF_Costello	Skin	Epidermis	Melanocyte
ENCSR899SWV.Fetal_Kidney_Cortex.UW_Glass	Urinary	Kidney	Kidney
ENCSR439SPU.Right_Ventricle.Stanford_Snyder	Cardiovascular	Heart	Ventricle
ENCSR000AAI.Dermis_Blood_Vessel_Endothelial_Primary_Cells.CSHL_Gingeras	Skin	Dermis	Endothelial
ENCSR696SMK.M059J_Glioblastoma_Cell_Line.CSHL_Gingeras	Nervous	Brain	Glioblastoma
ENCSR176WMG.Fetal_Lung.UW_Glass	Respiratory	Lung	Lung
ENCSR829INV.Cortex_derived_primary_cultured_neurospheres.UCSF_Costello	Nervous	Brain	Neurosphere
ENCSR123ZCX.Fetal_Stomach.UW_Glass	Gastrointestinal	Stomach	Stomach
ENCSR000EYT.NHEK.Epidermal_Keratinocyte_Primary_Cells.Caltech_Wold	Skin	Epidermis	Keratinocyte
ENCSR466XAR.Chorion.UCSF_Costello	Embryonic	Chorion	Chorion
ENCSR000COQ.GM12878_Lymphoblastoid_Cells.CSHL_Gingeras	Blood	Blood	Lymphoblastoid
ENCSR000COO.NHLF_Lung_Fibroblast_Primary_Cells.CSHL_Gingeras	Respiratory	Lung	Fibroblast
ENCSR000AEL.K562_Leukemia_Cells.CSHL_Gingeras	Blood	Blood	Leukemia
ENCSR000CUC.Monocytes.CD14._RO01746_Primary_Cells.CSHL_Gingeras	Blood	Blood	B.cell
ENCSR896QPD.Fetal_Kidney.UW_Glass	Urinary	Kidney	Kidney
ENCSR310FIS.MCF.7_Mammary_Gland_Adenocarcinoma_Cell_Line.UConn_Graveley	Breast	Gland	Adenocarcinoma
ENCSR741MLF.Chorion.UCSF_Costello	Embryonic	Chorion	Chorion
ENCSR029FTY.Fetal_Kidney_Pelvis.UW_Glass	Urinary	Kidney	Kidney
ENCSR000AAL.Nasal_Epithelial_Primary_Cells.CSHL_Gingeras	Nose	Nose	Epithelial
ENCSR252BHM.Fetal_Brain_Female.UCSF_Costello	Nervous	Brain	Brain
ENCSR000CPL.NHEK.Epidermal_Keratinocyte_Primary_Cells.CSHL_Gingeras	Skin	Epidermis	Keratinocyte
ENCSR557PFL.Placenta_Amnion.UCSF_Costello	Reproductive	Amnion	Amnion
ENCSR774SEX.Fetal_Stomach.UW_Glass	Gastrointestinal	Stomach	Stomach
ENCSR950PSB.H1_Cells.Cellular_Dynamics_International	Embryonic	ESC	ESC
ENCSR000AAM.Pulmonary_Artery_Endothelial_Primary_Cells.CSHL_Gingeras	Respiratory	Lung	Endothelial
ENCSR797BPP.Arm_Fibroblast_Primary_Cells.CSHL_Gingeras	Skin	Dermis	Fibroblast
ENCSR000CWL.GM12892_Lymphoblastoid_Cells.Caltech_Wold	Blood	Blood	Lymphoblastoid
ENCSR000COU.H1_Cells.CSHL_Gingeras	Embryonic	ESC	ESC
ENCSRMAR045.Primary_T_cells_effector_memory_enriched_from_peripheral_blood.Broad_Bernstein	Blood	Blood	T.cell
ENCSR000AAH.Cardiac_Myocyte_Primary_Cells.CSHL_Gingeras	Cardiovascular	Heart	Muscle
ENCSR000AFK.Fetal_Thyroid.CSHL_Gingeras	Endocrine	Thyroid	Thyroid
ENCSR449GLL.Primary_B_cells_from_peripheral_blood.FHCRC_Heimfeld	Blood	Blood	B.cell
ENCSR727VTD.Fetal_Ovary.UW_Glass	Reproductive	Ovary	Ovary
ENCSR721HDG.Gastric.Stanford_Snyder	Gastrointestinal	Stomach	Stomach
ENCSR256YHI.Cortex_derived_primary_cultured_neurospheres.UCSF_Costello	Nervous	Brain	Neurosphere
ENCSR000AHH.Fetal_Heart.CSHL_Gingeras	Cardiovascular	Heart	Heart
ENCSR410DUZ.Fetal_Kidney_Pelvis.UW_Glass	Urinary	Kidney	Kidney
ENCSR995ORR.Fetal_Muscle_Back.UW_Glass	Musculoskeletal	Muscle	Muscle
ENCSR000EYP.H1_Cells.Caltech_Wold	Embryonic	ESC	ESC
ENCSR000CUC.Primary_monocytes_from_peripheral_blood.CSHL_Gingeras	Blood	Blood	B.cell
ENCSR118TVR.Kidney_Proximal_Tube_Epithelial_Primary_Cells.CSHL_Gingeras	Urinary	Kidney	Epithelial
ENCSR328PVI.Fetal_Kidney_Cortex.UW_Glass	Urinary	Kidney	Kidney
ENCSR568YRP.SJCRH30_Rhabdomyosarcoma_Cell_Line.CSHL_Gingeras	Musculoskeletal	Metastasis	Sarcoma
ENCSR681ALA.Fetal_Skin_Fibroblast_Abdomen.UW_Glass	Skin	Dermis	Fibroblast
ENCSR899NLW.Fetal_Spinal_Cord.UW_Glass	Nervous	Brain	Spinal cord
ENCSR000AFN.Uterus.CSHL_Gingeras	Reproductive	Uterus	Uterus
ENCSR254JJM.Daoy_Desmoplastic_Cerebellar_Medulloblastoma_Cell_Line.CSHL_Gingeras	Nervous	Brain	Medulloblastoma
ENCSR204XBB.Fetal_Kidney_Pelvis.UW_Glass	Urinary	Kidney	Kidney
ENCSR096USV.Fetal_Muscle_Leg.UW_Glass	Musculoskeletal	Muscle	Muscle
ENCSR136WGP.SK.N.DZ_Neuroblastoma_Cell_Line.CSHL_Gingeras	Nervous	Metastasis	Neuroblastoma
ENCSR271DJJ.Pancreatic_Islets.UCSF_Costello	Endocrine	Pancreas	Islet
ENCSR000AED.GM12878_Lymphoblastoid_Cells.CSHL_Gingeras	Blood	Blood	Lymphoblastoid
ENCSR433GXV.hESC_Derived_CD56._Mesoderm_Cultured_Cells.Harvard	Embryonic	Mesoderm	Mesoderm
ENCSR535VTR.HT1080_Fibrosarcoma_Cell_Line.CSHL_Gingeras	Musculoskeletal	Stromal	Sarcoma
ENCSR000AEV.Bladder.CSHL_Gingeras	Urinary	Bladder	Bladder
ENCSR314LXG.Karpas.422_B_Cell_Non.Hodgkin_Lymphoma_Cell_Line.CSHL_Gingeras	Blood	Blood	Lymphoma
ENCSR642GSA.Primary_T_CD8._naive_cells_from_peripheral_blood.UCSF_Costello	Blood	Blood	T.cell
ENCSR880EGO.SJSA1_Osteosarcoma_Cell_Line.CSHL_Gingeras	Musculoskeletal	Bone	Sarcoma
ENCSR000AAT.Umbilical_Artery_Epithelial_Primary_Cells.CSHL_Gingeras	Reproductive	Umbilical cord	Epithelial
ENCSR000EYQ.HeLa.S3_Cervical_Carcinoma_Cell_Line.Caltech_Wold	Reproductive	Cervix	Carcinoma
